11111111111
1E000000001
1000C011101
1000000C011
10000001P11
11000011011
11111111111