11111111111
1E101000001
1001C111101
1000000C111
10000000P11
11000011011
11111111111